S,E,E,E,E,E,E,E,E,E
E,E,E,E,E,E,E,E,E,E
E,E,X,X,E,E,X,X,E,E
E,E,X,X,E,E,X,X,E,E
E,E,X,X,E,E,X,X,E,E
E,E,E,E,E,E,E,E,E,E
E,E,X,X,E,E,X,X,E,E
E,E,X,X,E,E,X,X,E,E
E,E,X,X,E,E,X,X,E,E
E,E,E,E,E,E,E,E,E,G