S,E,E,E,E,E,E,E,E,E,E,E,E,E,G
E,E,E,E,E,E,E,E,E,E,E,E,E,E,E
E,E,X,X,E,X,X,E,X,X,E,X,X,E,E
E,E,X,X,E,X,X,E,X,X,E,X,X,E,E
E,E,X,X,E,X,X,E,X,X,E,X,X,E,E
E,E,X,X,E,X,X,E,X,X,E,X,X,E,E
E,E,X,X,E,X,X,E,X,X,E,X,X,E,E
E,E,E,E,E,E,E,E,E,E,E,E,E,E,E
E,E,E,E,E,E,E,E,E,E,E,E,E,E,E
E,E,X,X,E,X,X,E,X,X,E,X,X,E,E
E,E,X,X,E,X,X,E,X,X,E,X,X,E,E
E,E,X,X,E,X,X,E,X,X,E,X,X,E,E
E,E,X,X,E,X,X,E,X,X,E,X,X,E,E
E,E,X,X,E,X,X,E,X,X,E,X,X,E,E
E,E,E,E,E,E,E,E,E,E,E,E,E,E,E
S,E,E,E,E,E,E,E,E,E,E,E,E,E,G