S,L,L,L,L,L,L,L,L,L,L,L,L,L,G
D,U,R,R,R,R,R,R,R,R,R,R,R,R,R
D,U,X,X,D,X,X,U,X,X,D,X,X,U,D
D,U,X,X,D,X,X,U,X,X,D,X,X,U,D
D,U,X,X,D,X,X,U,X,X,D,X,X,U,D
D,U,X,X,D,X,X,U,X,X,D,X,X,U,D
D,U,X,X,D,X,X,U,X,X,D,X,X,U,D
D,U,L,L,L,L,L,L,L,L,L,L,L,U,D
D,U,R,R,R,R,R,R,R,R,R,R,R,U,D
D,U,X,X,D,X,X,U,X,X,D,X,X,U,D
D,U,X,X,D,X,X,U,X,X,D,X,X,U,D
D,U,X,X,D,X,X,U,X,X,D,X,X,U,D
D,U,X,X,D,X,X,U,X,X,D,X,X,U,D
D,U,X,X,D,X,X,U,X,X,D,X,X,U,D
D,U,L,L,L,L,L,L,L,L,L,L,L,U,D
S,R,R,R,R,R,R,R,R,R,R,R,R,R,G
