S,L,L,L,L,L,L,L,L,L,L,L,L,L,G
D,R,R,R,R,R,R,R,R,R,R,R,R,R,U
D,U,X,X,D,X,X,U,X,X,D,X,X,D,U
D,U,X,X,D,X,X,U,X,X,D,X,X,D,U
D,U,X,X,D,X,X,U,X,X,D,X,X,D,U
D,U,X,X,D,X,X,U,X,X,D,X,X,D,U
D,U,X,X,D,X,X,U,X,X,D,X,X,D,U
D,L,L,L,L,L,L,L,L,L,L,L,L,L,U
D,R,R,R,R,R,R,R,R,R,R,R,R,R,U
D,U,X,X,D,X,X,U,X,X,D,X,X,D,U
D,U,X,X,D,X,X,U,X,X,D,X,X,D,U
D,U,X,X,D,X,X,U,X,X,D,X,X,D,U
D,U,X,X,D,X,X,U,X,X,D,X,X,D,U
D,U,X,X,D,X,X,U,X,X,D,X,X,D,U
D,L,L,L,L,L,L,L,L,L,L,L,L,L,U
S,R,R,R,R,R,R,R,R,R,R,R,R,R,G
