S,E,E,E,E,E,E,E,E,E,E,E,E,E,G
E,E,E,E,E,E,E,E,E,E,E,E,E,E,E
E,E,X,X,D,X,X,U,X,X,D,X,X,E,E
E,E,X,X,D,X,X,U,X,X,D,X,X,E,E
E,E,X,X,D,X,X,U,X,X,D,X,X,E,E
E,E,X,X,D,X,X,U,X,X,D,X,X,E,E
E,E,X,X,D,X,X,U,X,X,D,X,X,E,E
E,E,E,E,E,E,E,E,E,E,E,E,E,E,E
E,E,E,E,E,E,E,E,E,E,E,E,E,E,E
E,E,X,X,D,X,X,U,X,X,D,X,X,E,E
E,E,X,X,D,X,X,U,X,X,D,X,X,E,E
E,E,X,X,D,X,X,U,X,X,D,X,X,E,E
E,E,X,X,D,X,X,U,X,X,D,X,X,E,E
E,E,X,X,D,X,X,U,X,X,D,X,X,E,E
E,E,E,E,E,E,E,E,E,E,E,E,E,E,E
S,E,E,E,E,E,E,E,E,E,E,E,E,E,G
